11111111111
1PPPPPPPPP1
10000000001
10000000E01
1bbbbbbbbb1
11111111111
