11111111111111111111111111111111111
1P00000000000000C000000000000000011
10100100101010100010010000000101011
10000000000000000000000000000000011
10000000000000000000000000000000011
10000100000000000000000000010000011
11111111111100000000000000000000011
11110000000000011100000000000000011
11000000000001110000000000000000011
10000000000000000000000000000000011
10000000000000000000000000000000011
11110000000000000000000000000011111
10000000000000000000000000011111111
11111111111100000000000001111111111
11110000000000000000000000000011111
10000000000000000000000000000000E11
11000000000001110000000000000000011
10000000000000000000000000000000011
11110000000000000000000000000011111
10000000000000000000000000011111111
11111111111100000000000001111111111
11110000000000000000000000000011111
10000000000000000000000000000000011
11111111111111111111111111111111111